400404004
033030330
221030122
001232100
110000011