111101111
222000222
330000033
400000004
330000033
222000222
111101111