111111111
121111121
133333331
121111121
111111111