400444004
333000333
000222000
101010101
000222000
333000333
400444004