111222111
110020011
312000213
111111111
000040000