300040003
004404400
040333040
004404400
220040022